..........................
...................#......
...................#......
...................######.
..........................
.............#............
.............##...........
..............##..........
...............##.........
................##........
.................##.......
.............X....#.......
..........................
....######................
.........#................
.........#................
.........#................
.........#................
.........#................
.........#................
..........................
..........................
..........................
..........................
..........................
@.........................
