..................................................
.######............#..............................
.#....#............#..............................
.#....#............######.........................
.######...........................................
.............#....................................
########.....##...................................
.......#......##..................................
.......#.......##.................................
#.######........##................................
#.#..............##...............................
#.#...............#...............................
#.#...............................................
#.########........................................
#X.......#........................................
########?#........................................
..................................................
..................................................
..................................................
..................................................
###################################...............
#.......#...#.....#.........#.#..X#.#.............
#.#####.#...#.###.#.###.###.#.#...#.#.............
#.#...#.#.#.#...#.#.#...#.....#.#.#.#.............
#.#...#.###.###.#.###.#######.#.#.#.#.............
#.#.#.#.........#...#.......#...#.#.#.............
#.#.#.#############.#######.#######.#.............
#.#.#...#.........#.......#...#.....#.............
#.###...#.#######.#######.#...#.#####.............
#.....#.#.....#.#.......#.#.#.#.....#.............
#.###.#.#####.#.#######.#.###.#####.#.............
#...#.#.....#.#.......#.#.........#.#.............
###########.#.#...###.#.#########.#.#.............
#...........#.#.#...#.#.......#.#.#.#.............
#...#########.#.###.#.#######.#.#.#.#.............
#.#.#.........#.#...#.....#.#.#...#.#.............
#.#.#.#########.#.#######.#.#.#.###.#.............
#.#.#...#...#...#...#.....#.#.#.#...#.............
###.###.#...#.#####.#.#####.#.###.###.............
#.......#.#.#.....#.#...#...#...#...#.............
#...#####.#.#####.#.###.#...###.###.#.............
#.#.......#.......#...#...#...#.....#.............
#.###################################.............
..................................................
..................................................
..................................................
..................................................
..................................................
..................................................
@.................................................
